##################
##**************##
#*h.............*#
#*.........hHh..*#
#*...h..........*#
#*.H***....***..*#
#*..*........*..*#
#*..*.H......*..*#
#*..*......h.*..*#
#*..*.......h*.h*#
#*..*........*..*#
#*..*..hH.h..*..*#
#*..***....***..*#
#*............hH*#
#*...H...H......*#
#*..hhH.........*#
##**************##
##################

1 8  13
2 9  13
T 2  15
T 2  2
B 2  2
B 15 2
G 2  15
G 15 15