##################
##**************##
#*............*.*#
#*.........hHh***#
#*...h...R......*#
#*.H............*#
#*...........R..*#
#*....***.......*#
#*....*.*..h....*#
#*....***...h..h*#
#*.........***..*#
#*..R..hH.h*.*..*#
#*.........***..*#
#*............hH*#
#***.H...H....***#
#*.*hhH....R..*.*#
##**************##
##################

1 8  13
2 9  13
B 15 2
B 3  2
B 7 8
B 12 11
B 2  15
B 15 15
G 15 2
G 3  2
G 7 8
G 12 11
G 2  15
G 15 15