##################
#.......##.......#
#.......##.......#
#.......##.......#
#...**********...#
#...**********...#
#...****..****...#
#...****..****...#
####****..****####
####****..****####
#...****..****...#
#...****..****...#
#...**********...#
#...**********...#
#.......##.......#
#.......##.......#
#.......##.......#
##################

1 1 1
2 1 2
S 8 6
C 16 1
C 16 16
C 1 16
& 1 10
& 7 14
& 10 14
& 14 10
& 3 7
& 7 3
& 14 7
& 7 14
