##################
#..F*........*F..#
#...**********...#
#................#
#F..............F#
#**............**#
#.*...FFFFFF...*.#
#.*...F....F...*.#
#.*...F....F...*.#
#.*...F....F...*.#
#.*...F....F...*.#
#.*...FFFFFF...*.#
#**............**#
#F..............F#
#................#
#...**********...#
#..F*........*F..#
##################

1 1 1
2 1 2
N 3 11
N 14 11
P 1 6
P 16 6
P 5 1
P 5 16
